Fabiane	Lateinisch	weiblich	Siehe männliche FormFabian
Farren	Altfranzösisch	weiblich	möglicherweise von einem englischen Familiennamen, der auf das altfranzösische Wort 'ferrant' zurückgeht
Fathiyya	Arabisch	weiblich	die Eroberin
Fausta	Lateinisch	weiblich	die Glückbringende
Fe	Spanisch	weiblich	Vertrauen, Glaube
Felizia	Lateinisch	weiblich	die Glückliche
Felizitas	Lateinisch	weiblich	Glück
Fenja	Deutsch	weiblich	Koseform von Namen mit dem Element 'Fried-' bzw. 'Frede-', wie z.B. Frederike
Fina	Spanisch	weiblich	verselbständigte Kurzform von Namen, die auf '-fina' enden, speziell Josefina
Fiona	Altirisch	weiblich	die Blonde
Flavia	Lateinisch	weiblich	die Blonde
Franziska	Italienisch	weiblich	die kleine Französin
Hadassah	Hebräisch	weiblich	Myrte, Myrtenstrauch
Haidee	Altgriechisch	weiblich	vom englischen Dichter Byron für sein Gedicht 'Don Juan' (1818) erfunden
Hanifah	Arabisch	weiblich	aufrichtig, rechtschaffen, rechtgläubig
Hatifa	Arabisch	weiblich	die Liebevolle?, die Zärtliche?
Hazel	Englisch	weiblich	Hasel
Hedwig	Althochdeutsch	weiblich	alter deutscher zweigliedriger Name
Heilke	Deutsch	weiblich	niederdeutsche/friesische Kurzform von Namen mit 'heil' als erstem Bestandteil, wie z.B. 'Heilgard'
Helene	Altgriechisch	weiblich	die Strahlende
Helga	Altnordisch	weiblich	heilig
Helma	Deutsch	weiblich	verselbständigte Kurzform von Namen mit dem Element 'helm', wie z.B. 'Helmtraud' und 'Wilhelma'
Henrietta	Althochdeutsch	weiblich	Siehe männliche FormHeinrich
Herdis	Altnordisch	weiblich	her=das Heer (Altnordisch) ; dis=die Göttin (Altnordisch)
Hiddekel	Hebräisch	weiblich	rasch (?)
Hilaria	Lateinisch	weiblich	die Heitere
Hildegard	Althochdeutsch	weiblich	alter deutscher zweigliedriger Name
Hjördis	Altnordisch	weiblich	hjorr=das Schwert (Altnordisch) ; dis=die Göttin (Altnordisch)
Honey	Englisch	weiblich	Honig
Honorée	Lateinisch	weiblich	die Geehrte
Yamawadee	Thai	weiblich	in einer besonderen Zeit geboren (?)
Yela	Kimbundu	weiblich	Willkommen
Yuna	Japanisch	weiblich	bedeutet auch 'Mond' im japanischen Dialekt von Okinawa
Yvonne	Althochdeutsch	weiblich	die Bogenschützin (?)
Mabel	Lateinisch	weiblich	die Liebenswerte
Mabra	Unbekannt	weiblich	vielleicht von 'Mabry', einer abgewandelten Form des Familiennamens 'Maybury'
Magdalena	Hebräisch	weiblich	die aus Magdala Stammende
Maira	Altgriechisch	weiblich	vielleicht von einem griechischen Namen für den Stern Sirius
Maja	Lateinisch	weiblich	Amme, Hebamme (?)
Malak	Arabisch	weiblich	Engel
Malika	Arabisch	weiblich	Königin
Malwine	Englisch	weiblich	im 18. Jh. von James Mcpherson für seine Ossian-Dichtung erfunden
Manavi	Unbekannt	weiblich	erste Frau, ursprüngliche Frau (?)
Mandana	Persisch	weiblich	ewig, unvergänglich
Manuela	Hebräisch	weiblich	Gott sei mit uns
Mara	Hebräisch	weiblich	bitter
Marcella	Lateinisch	weiblich	dem Mars (dem römischen Kriegsgott) geweiht
Margarete	Altgriechisch	weiblich	die Perle
Maria	Hebräisch	weiblich	Verbitterung (?)
Marianne	Hebräisch	weiblich	Doppelform aus Maria und Anna
Marie-Florence	Französisch	weiblich	Doppelform aus 'Marie' und 'Florence'
Marina	Lateinisch	weiblich	vom Meer, am Meer lebend
Maris	Lateinisch	weiblich	von einem lateinischen Titel 'stella maris' (Stern des Meeres) für Maria, die Mutter von Jesus
Marlene	Deutsch	weiblich	Doppelform aus 'Maria' und 'Lena' (Kurzform von Magdalena)
Martha	Aramäisch	weiblich	Herrin, Gebieterin
Martina	Lateinisch	weiblich	Siehe männliche FormMartin
Marzanna	Altslawisch	weiblich	in der slawischen Mythologie ist Marzanna die Göttin des Winters und des Todes
Mathilde	Althochdeutsch	weiblich	alter deutscher zweigliedriger Name
Maxima	Lateinisch	weiblich	die Grösste
Melanie	Altgriechisch	weiblich	die Dunkle, die Schwarze
Melina	Altgriechisch	weiblich	Frau von der Insel Melos (?)
Melissa	Altgriechisch	weiblich	die Biene
Mercedes	Lateinisch	weiblich	ursprünglich der Name des Marienfestes 'Maria de mercede redemptionis captivorum' ('Maria von der Gnade der Gefangenenerlösung')
Merlind	Althochdeutsch	weiblich	alter deutscher zweigliedriger Name
Michaela	Hebräisch	weiblich	Wer ist wie Gott?
Michal	Hebräisch	weiblich	Bach (?)
Milena	Altslawisch	weiblich	Siehe männliche FormMilan
Mireille	Provenzalisch	weiblich	französische Form von provenzalisch 'Mirèio'
Mirna	Altslawisch	weiblich	als slawischer Name abgeleitet von 'mir' (Frieden)
Moana	Maori	weiblich	moana=das Meer (Maori)
Monika	Lateinisch	weiblich	Herkunft nicht sicher bekannt
Morgana	Keltisch	weiblich	Siehe männliche FormMorgan
Myrine	Unbekannt	weiblich	in der griechischen Mythologie ist Myrine eine Königin der Amazonen
Hagen	Althochdeutsch	männlich	Heger, Beschützer
Hanif	Arabisch	männlich	aufrichtig, rechtschaffen, rechtgläubig
Hans-Rudolf	Deutsch	männlich	Doppelform aus 'Hans' und 'Rudolf'
Harald	Althochdeutsch	männlich	Heerführer
Hares	Arabisch	männlich	Beschützer
Hartmut	Althochdeutsch	männlich	alter deutscher zweigliedriger Name
Hartwig	Althochdeutsch	männlich	alter deutscher zweigliedriger Name
Harvey	Keltisch	männlich	des Kampfes würdig
Haytham	Arabisch	männlich	junger Adler (?)
Heinrich	Althochdeutsch	männlich	alter deutscher zweigliedriger Name
Helmer	Althochdeutsch	männlich	alter deutscher zweigliedriger Name
Helmut	Althochdeutsch	männlich	alter deutscher zweigliedriger Name
Herbert	Althochdeutsch	männlich	alter deutscher zweigliedriger Name
Hercli	Rätoromanisch	männlich	Hercli&nbsp;&nbsp;Rätoromanisch&nbsp;&nbsp;
Hermann	Althochdeutsch	männlich	alter deutscher zweigliedriger Name
Hieronymus	Altgriechisch	männlich	heiliger Name
Hilarius	Lateinisch	männlich	der Heitere
Hillert	Unbekannt	männlich	sehr selten als Vorname, häufiger als Familienname
Hjalmar	Altnordisch	männlich	behelmter Krieger
Holger	Altnordisch	männlich	alter deutscher zweigliedriger Name
Honoré	Lateinisch	männlich	der Geehrte
Horaz	Etruskisch	männlich	altrömischer Familienname, vielleicht etruskischen Ursprungs
Horst	Althochdeutsch	männlich	Gebüsch, Unterholz (?)
Hubert	Althochdeutsch	männlich	alter deutscher zweigliedriger Name
Hugo	Althochdeutsch	männlich	verselbständigte Kurzform von Namen mit 'Hug-', wie z.B. 'Hugbert', einer alten Form von 'Hubert'
Humbert	Althochdeutsch	männlich	alter deutscher zweigliedriger Name
Hunfried	Althochdeutsch	männlich	alter deutscher zweigliedriger Name
Eberhard	Althochdeutsch	männlich	stark wie ein Eber
Eckhard	Althochdeutsch	männlich	alter deutscher zweigliedriger Name
Edgar	Altenglisch	männlich	im 19. Jh. aus dem Englischen ins Deutsche übernommen
Edmund	Altenglisch	männlich	alter englischer zweigliedriger Name
Eduard	Altenglisch	männlich	Hüter seines Besitzes
Edwin	Altenglisch	männlich	begüterter Freund
Egmont	Althochdeutsch	männlich	alter deutscher zweigliedriger Name
Egon	Althochdeutsch	männlich	ursprünglich 'Egino', eine verselbständigte Kurzform von Namen mit Egin-, z.B. Eginhard
Ehrenfried	Deutsch	männlich	um 1600 aufgekommener Vorname, wahrscheinlich als Neubildung aus dem Wort 'Ehre' und der gebräuchlichen Namensendung '-fried'
Elbasan	Unbekannt	männlich	vielleicht von der gleichnamigen Stadt in Albanien
Elias	Hebräisch	männlich	mein Gott ist Jahwe
Elmar	Althochdeutsch	männlich	alter deutscher zweigliedriger Name
Elric	Althochdeutsch	männlich	alt=alt (Althochdeutsch) ; rihhi=reich, mächtig, die Macht, die Herrschaft, der Herrscher (Althochdeutsch)
Emil	Lateinisch	männlich	ursprünglich ein römischer Familienname
Erich	Altnordisch	männlich	der allein Herrschende
Erkenbald	Althochdeutsch	männlich	alter deutscher zweigliedriger Name
Ernst	Althochdeutsch	männlich	der Ernste, der Gestrenge
Erwin	Althochdeutsch	männlich	alter deutscher zweigliedriger Name
Eugen	Altgriechisch	männlich	wohlgeboren, von edler Herkunft
Pamela	Altgriechisch	weiblich	die ganz Schwarze (?), die ganz Süsse (?)
Patrizia	Lateinisch	weiblich	die Vornehme
Paula	Lateinisch	weiblich	die Kleine, die Jüngere
Petra	Altgriechisch	weiblich	der Felsen, der Stein
Pia	Lateinisch	weiblich	die Fromme
Pina	Italienisch	weiblich	italienische verselbständigte Kurzform von Namen, die auf '-pina' enden, vor allem Giuseppina
Praxedis	Altgriechisch	weiblich	die Wohltätige
Priska	Lateinisch	weiblich	die Alte
Caecilie	Lateinisch	weiblich	weibliche Form des altrömischen Familiennamens 'Caecilius'
Cara	Italienisch	weiblich	die Liebe, die Teure
Cari	Walisisch	weiblich	Liebe
Carina	Italienisch	weiblich	hübsch, lieb
Carmen	Hebräisch	weiblich	von spanisch 'Virgen del Carmen' (Jungfrau Maria vom Berg Karmel in Palästina)
Ceara	Altirisch	weiblich	leuchtend-rot
Celina	Lateinisch	weiblich	Siehe männliche FormCelio
Chantal	Französisch	weiblich	vom Familiennamen der französischen Heiligen Jeanne Françoise Frémont de Chantal
Charlotte	Althochdeutsch	weiblich	Siehe männliche FormKarl
Chioma	Igbo	weiblich	Gott ist gut
Chloe	Altgriechisch	weiblich	junges Grün, junger Trieb
Christine	Lateinisch	weiblich	christliche Frau
Cinta	Unbekannt	weiblich	Liebe
Claudia	Lateinisch	weiblich	der Hinkende
Cölestina	Lateinisch	weiblich	die Himmlische
Colombe	Lateinisch	weiblich	Taube
Cora	Deutsch	weiblich	im Deutschen entstanden als verselbständigte Kurzform von 'Cordula', 'Cordelia' und 'Cornelia'
Cordula	Lateinisch	weiblich	spät geboren
Corinna	Altgriechisch	weiblich	Mädchen, Jungfrau
Cornelia	Lateinisch	weiblich	Siehe männliche FormCornelius
Corona	Lateinisch	weiblich	die Gekrönte
Cynthia	Altgriechisch	weiblich	die vom Berge Kynthos auf der Insel Delos Stammende
Xaver	Baskisch	männlich	ursprünglich Beiname des hl. Franz Xaver auf Schloss Xavier bei Pamplona (Spanien, 16. Jh.)
Valentin	Lateinisch	männlich	der Kräftige, der Starke
Valerian	Lateinisch	männlich	der Starke, der Gesunde
Valerius	Lateinisch	männlich	der Starke, der Gesunde
Vernon	Altfranzösisch	männlich	von einem aristokratischen Familiennamen, der mit den Normannen nach England kam
Viktor	Lateinisch	männlich	der Sieger
Vinzenz	Lateinisch	männlich	der Siegende
Vittorio	Lateinisch	männlich	vom römischen Familiennamen 'Victorius', der von 'Victor' abgeleitet ist
Vivian	Etruskisch	männlich	ursprünglich ein römischer Name 'Vibianus' bzw. 'Vivianus', der auf einen römischen Familiennamen 'Vibius' zurückgeht
Volker	Althochdeutsch	männlich	alter deutscher zweigliedriger Name
Volkhard	Althochdeutsch	männlich	alter deutscher zweigliedriger Name
Volkmar	Althochdeutsch	männlich	alter deutscher zweigliedriger Name
Quentin	Lateinisch	männlich	der Fünfte; der im fünften Monat Geborene
Quirin	Lateinisch	männlich	geht zurück auf 'Quirinus', dem Namen der Sabiner für den Kriegsgott Mars
Odin	Altnordisch	männlich	der Inspirierte
Olinto	Altgriechisch	männlich	von 'Olynthos' oder 'Olinthos', dem Namen einer wichtigen Stadt im alten Griechenland
Oliver	Althochdeutsch	männlich	von der altfranzösischen Form eines germanischen/althochdeutschen Namens
Oskar	Altnordisch	männlich	alter skandinavischer zweigliedriger Name
Oswald	Althochdeutsch	männlich	alter deutscher zweigliedriger Name
Ottfried	Althochdeutsch	männlich	alter deutscher zweigliedriger Name
Ottmar	Althochdeutsch	männlich	alter deutscher zweigliedriger Name
Otto	Althochdeutsch	männlich	verselbständigte Kurzform von Namen beginnend mit 'Ot-', wie z.B. Ottmar
Gabriel	Hebräisch	männlich	Mann Gottes, Held Gottes; Gott ist mein Held
Gaston	Althochdeutsch	männlich	der Gast, der Fremde (?)
Geoffrey	Germanisch	männlich	alter germanischer zweigliedriger Name, dessen altfranzösische Form populär wurde
Georg	Altgriechisch	männlich	der Landarbeiter, der Bauer
Gerald	Althochdeutsch	männlich	alter deutscher zweigliedriger Name
Gerhard	Althochdeutsch	männlich	alter deutscher zweigliedriger Name
German	Unbekannt	männlich	der Germane
Gernot	Althochdeutsch	männlich	alter deutscher zweigliedriger Name
Gianluca	Italienisch	männlich	Doppelform aus 'Gianni' und 'Luca'
Gideon	Hebräisch	männlich	Holzfäller, Holzhauer (?)
Gilbert	Althochdeutsch	männlich	alter deutscher zweigliedriger Name
Giosch	Unbekannt	männlich	vielleicht eine rätoromanische Form von 'Josua' oder 'Josef'
Glen	Keltisch	männlich	aus dem Tal (?)
Gordon	Keltisch	männlich	grosser Hügel (?)
Gottfried	Althochdeutsch	männlich	alter deutscher zweigliedriger Name
Gregor	Altgriechisch	männlich	der Wachsame
Guido	Althochdeutsch	männlich	romanisierte Form von 'Wido', der Kurzform von Namen beginnend mit 'Wid-', wie etwa 'Witold'
Gunthard	Althochdeutsch	männlich	alter deutscher zweigliedriger Name
Günther	Althochdeutsch	männlich	alter deutscher zweigliedriger Name
Gustaf	Altnordisch	männlich	aus dem Schwedischen ins Deutsche übernommener Name
Baker	Englisch	männlich	Gebrauch der Berufsbezeichnung als Vorname
Baptist	Altgriechisch	männlich	der Täufer
Beat	Lateinisch	männlich	der Glückliche, der Glückselige
Benedikt	Lateinisch	männlich	der Gesegnete
Benjamin	Hebräisch	männlich	Sohn der rechten Hand, Sohn des Südens, Sohn des Glücks
Bernhard	Althochdeutsch	männlich	alter deutscher zweigliedriger Name
Bert	Althochdeutsch	männlich	verselbständigte Kurzform von Namen mit dem Element 'bert', z.B. Berthold, Bertram oder Albert
Berthold	Althochdeutsch	männlich	alter deutscher zweigliedriger Name
Bertram	Althochdeutsch	männlich	glänzender Rabe
Blaise	Lateinisch	männlich	der Lispelnde
Boris	Unbekannt	männlich	Wolf (?)
Borislaw	Altslawisch	männlich	boru=der Kampf (Altslawisch) ; slava=der Slawe, der Ruhm (Altslawisch)
Brian	Keltisch	männlich	aus dem Englischen übernommen, irischen oder bretonischen Ursprungs
Bringfried	Deutsch	männlich	Bringe Frieden!
Bruno	Althochdeutsch	männlich	der Braune
Burkhard	Althochdeutsch	männlich	alter deutscher zweigliedriger Name
Jaeger	Deutsch	männlich	Jäger
Jahwe	Hebräisch	männlich	Ich werde sein
Jakob	Hebräisch	männlich	Jahwe möge schützen; Fersenhalter; er betrügt
Janiv	Hebräisch	männlich	er wird Erfolg haben (?)
Jason	Altgriechisch	männlich	in der griechischen Mythologie ist Jason der Führer der Argonauten auf der Suche nach dem Goldenen Vlies
Jean-Claude	Französisch	männlich	Doppelform aus 'Jean' und 'Claude'
Jeremias	Hebräisch	männlich	Jahwe erhöht
Joachim	Hebräisch	männlich	Jahwe richtet auf
Joah	Hebräisch	männlich	Jahwe ist Bruder
Joel	Hebräisch	männlich	Jahwe ist Gott
Johannes	Hebräisch	männlich	Jahwe ist gnädig, Jahwe ist gütig
Jonas	Hebräisch	männlich	die Taube
Jonathan	Hebräisch	männlich	Jahwe hat gegeben, Geschenk von Jahwe
Jordan	Hebräisch	männlich	der Herabsteigende
Joseph	Hebräisch	männlich	Er (Gott) fügt hinzu
Josselin	Altfranzösisch	männlich	ursprünglich 'Gautzelin', abgeleitet vom Stammesnamen der Goten, als doppelte Verkleinerung
Josua	Hebräisch	männlich	Gott ist Hilfe/Heil/Rettung
Julian	Lateinisch	männlich	ursprünglich ein von 'Julius' abgeleiteter römischer Beiname 'Julianus'
Julius	Lateinisch	männlich	ursprünglich ein römischer Familienname
Justus	Lateinisch	männlich	der Gerechte
Ignaz	Etruskisch	männlich	ursprünglich ein römischer Familiennamen 'Egnatius', vielleicht mit etruskischen Wurzeln oder abgeleitet von lateinisch 'ignis' (Feuer)
Ilai	Hebräisch	männlich	Erhaben
Ilan	Hebräisch	männlich	Baum
Imko	Friesisch	männlich	Siehe weibliche FormImke
Indigo	Englisch	männlich	Indigo
Ingo	Althochdeutsch	männlich	verselbständigte Kurzform von Namen beginnend mit 'Ing(o)-', z.B. 'Ingmar' und 'Ingobert'
Ingvar	Altnordisch	männlich	altnordischer zweigliedriger Name
Isaak	Hebräisch	männlich	Er (Gott) lächelt zu
Ivo	Althochdeutsch	männlich	der Bogenschütze (?)
Taymur	Unbekannt	männlich	vielleicht eine arabische Variante des Namens 'Timur', bekannt durch den Mongolenherrscher Timur-Leng (14. Jh.)
Thaer	Arabisch	männlich	Rebell
Theobald	Althochdeutsch	männlich	alter deutscher zweigliedriger Name
Theodor	Altgriechisch	männlich	das Geschenk Gottes
Thomas	Aramäisch	männlich	Zwilling
Thorsten	Altnordisch	männlich	alter skandinavischer zweigliedriger Name
Tiberius	Lateinisch	männlich	dem Flussgott 'Tiberis' geweiht
Till	Althochdeutsch	männlich	Kurzform von Namen, die mit 'Diet-' gebildet sind, besonders von Dietrich
Timon	Altgriechisch	männlich	ehrenwerter Mann
Timotheus	Altgriechisch	männlich	Gott ehrend
Titus	Lateinisch	männlich	römischer Vorname unbekannter Herkunft
Tobias	Hebräisch	männlich	Jahwe ist gütig
Naarah	Hebräisch	weiblich	Mädchen, Magd
Nadjeschda	Russisch	weiblich	Hoffnung
Naiara	Baskisch	weiblich	die Wanderin (?)
Nala	Suaheli	weiblich	Löwin
Nalani	Hawaiianisch	weiblich	das Himmelszelt
Nanna	Altnordisch	weiblich	in der nordischen Mythologie ist Nanna eine Muttergöttin, die Frau Baldurs
Natalie	Lateinisch	weiblich	die an Weihnachten Geborene
Navina	Sanskrit	weiblich	die Neue
Nayeli	Unbekannt	weiblich	Ich liebe dich (?)
Neva	Unbekannt	weiblich	vielleicht abgeleitet von spanisch 'nieve' (Schnee) oder 'nevar' (schneien)
Nicole	Altgriechisch	weiblich	Sieg des Volkes
Nina	Italienisch	weiblich	verselbständigte Kurzform von Namen, die auf -nina enden, z.B. Antonina
Noah	Hebräisch	weiblich	Bewegung
Noemi	Hebräisch	weiblich	Freundlichkeit
Noena	Unbekannt	weiblich	vielleicht eine Variante von 'Nona', einem Vornamen lateinischer Herkunft mit der Bedeutung 'die Neunte'
Norma	Italienisch	weiblich	erfunden von Felice Romani für die Oper 'Norma' (1832)
Numa	Unbekannt	weiblich	bedeutet vielleicht 'schön' in Arabisch
Nurana	Turkmenisch	weiblich	hübsch
Nyima	Tibetanisch	weiblich	Sonne
Rachel	Hebräisch	weiblich	das Mutterschaf
Raeanne	Englisch	weiblich	Doppelform aus 'Rae' und 'Anne'
Ramona	Althochdeutsch	weiblich	Siehe männliche FormRaimund
Rebekka	Hebräisch	weiblich	die Bestrickende, die Fesselnde (?)
Regina	Lateinisch	weiblich	die Königin
Regula	Lateinisch	weiblich	geht zurück auf einen römischen Beinamen 'regulus' 'kleiner König'
Renate	Lateinisch	weiblich	die Wiedergeborene
Rhian	Walisisch	weiblich	das Mädchen, die Jungfrau
Riccarda	Althochdeutsch	weiblich	Siehe männliche FormRichard
Rim	Arabisch	weiblich	weisse Antilope
Rojan	Persisch	weiblich	Tag, Licht (?)
Romea	Lateinisch	weiblich	Rom-Pilger
Romilda	Althochdeutsch	weiblich	hruom=der Ruhm, die Ehre (Althochdeutsch) ; hiltja=der Kampf (Althochdeutsch)
Rosa	Lateinisch	weiblich	die Rose
Rosalinde	Althochdeutsch	weiblich	alter deutscher zweigliedriger Name
Roswitha	Althochdeutsch	weiblich	alter deutscher zweigliedriger Name
Roxana	Altpersisch	weiblich	strahlend, Morgenröte
Runa	Altnordisch	weiblich	Siehe männliche FormRune
Ruqayyah	Unbekannt	weiblich	sanftmütig (?)
Ruth	Hebräisch	weiblich	Freundschaft
Sabine	Lateinisch	weiblich	die Sabinerin
Sabrina	Keltisch	weiblich	Name der Nymphe des Flusses Severn in England
Salbjörg	Altnordisch	weiblich	alter nordischer zweigliedriger Name
Salome	Hebräisch	weiblich	die Friedliche, die Friedsame
Samantha	Englisch	weiblich	Herkunft umstritten
Samira	Arabisch	weiblich	Siehe männliche FormSamir
Sanura	Unbekannt	weiblich	Kätzchen (?)
Sarah	Hebräisch	weiblich	die Fürstin
Saskia	Althochdeutsch	weiblich	die Sächsin
Scarlett	Altenglisch	weiblich	von einem Familiennamen, der ursprünglich eine Berufsbezeichnung war für jemanden, der Kleider aus scharlachrotem Stoff verkauft oder herstellt
Schwanhilde	Althochdeutsch	weiblich	alter deutscher zweigliedriger Name
Selina	Altgriechisch	weiblich	Mond
Selma	Keltisch	weiblich	Ursprung umstritten
Seraphina	Hebräisch	weiblich	Engel
Serena	Lateinisch	weiblich	die Heitere
Severina	Lateinisch	weiblich	die Ernsthafte
Sevil	Türkisch	weiblich	geliebt (?)
Shalimar	Unbekannt	weiblich	Wohnsitz der Liebe (?)
Sharon	Hebräisch	weiblich	Ebene
Shila	Sanskrit	weiblich	Stein, Hügel, Berg
Shirin	Altpersisch	weiblich	süss
Shirley	Altenglisch	weiblich	helle Lichtung
Sibylle	Altgriechisch	weiblich	die Prophetin
Sidonia	Lateinisch	weiblich	Frau aus Sidon
Sigrid	Altnordisch	weiblich	alter skandinavischer zweigliedriger Name
Silvana	Lateinisch	weiblich	Siehe männliche FormSilvan
Silvia	Lateinisch	weiblich	Frau aus dem Wald
Simin	Persisch	weiblich	silbern, silbrig
Simone	Hebräisch	weiblich	Er (Gott) hat gehört
Sina	Deutsch	weiblich	verselbständigte Kurzform von Namen auf -sina, z.B. Rosina
Snezana	Slawisch	weiblich	snjeg=der Schnee (Slawisch) ; zena=die Frau (Slawisch)
Sofia	Altgriechisch	weiblich	Weisheit
Solidea	Lateinisch	weiblich	nur für Gott
Solveig	Altnordisch	weiblich	bekannt durch die Gestalt der Solvejg in Henrik Ibsens Drama 'Peer Gynt' (1876)
Stanislava	Altslawisch	weiblich	Siehe männliche FormStanislaw
Stefanie	Altgriechisch	weiblich	die Gekrönte
Stella	Lateinisch	weiblich	der Stern
Stine	Skandinavisch	weiblich	verselbständigte Kurzform von Namen, die auf '-stine' enden, vor allem Christine
Sunna	Althochdeutsch	weiblich	Sonne
Susanne	Hebräisch	weiblich	Lilie
Svala	Altnordisch	weiblich	Schwalbe
Svea	Altnordisch	weiblich	schwedischer Vorname, gebildet aus dem ersten Bestandteil des alten Namens von Schweden 'Svearike'
Svenja	Altnordisch	weiblich	Jüngling, junger Mann
Zacharias	Hebräisch	männlich	Jahwe hat sich erinnert
Olivia	Lateinisch	weiblich	der Olivenbaum, die Olive
Ornella	Italienisch	weiblich	erfunden durch G. d'Annunzio für eine Gestalt seiner Tragödie 'La figlia di Iorio' (1904)
Ostara	Althochdeutsch	weiblich	Herkunft unsicher, vielleicht vom Namen 'Eostre' (Altenglisch) bzw. 'Ostara' (Althochdeutsch) einer germanischen Frühlingsgöttin
Palmiro	Lateinisch	männlich	der Pilger
Paschalis	Lateinisch	männlich	der Österliche
Patrick	Lateinisch	männlich	der Vornehme
Paul	Lateinisch	männlich	der Kleine, der Jüngere
Peter	Altgriechisch	männlich	der Felsen, der Stein
Philemon	Altgriechisch	männlich	gütig, liebevoll
Philipp	Altgriechisch	männlich	der Pferdefreund
Pius	Lateinisch	männlich	der Fromme
Placidus	Lateinisch	männlich	der Sanfte, der Friedliche
Pollux	Altgriechisch	männlich	sehr süss
Damian	Altgriechisch	männlich	Name verbreitet durch den hl. Damianus, Arzt und Märtyrer
Dan	Hebräisch	männlich	Er (Gott) hat gerichtet
Daniel	Hebräisch	männlich	Gott sei mein Richter
Dankmar	Althochdeutsch	männlich	alter deutscher zweigliedriger Name
Darius	Altpersisch	männlich	das Gute festhaltend; Inhaber des Guten
David	Hebräisch	männlich	der Geliebte
Delfred	Unbekannt	männlich	sehr seltener Name mit vielleicht althochdeutscher Herkunft  mit der Endung '-fred' vom Wort 'fridu' (Friede)
Dempsey	Altirisch	männlich	Nachfahre von Diomasach
Dennis	Altgriechisch	männlich	der dem Dionysos Geweihte
Deri	Walisisch	männlich	Eichen
Detlev	Althochdeutsch	männlich	alter deutscher zweigliedriger Name
Diarmaid	Altirisch	männlich	freier Mann
Dieter	Althochdeutsch	männlich	alter deutscher zweigliedriger Name
Dietmar	Althochdeutsch	männlich	alter deutscher zweigliedriger Name
Dietrich	Althochdeutsch	männlich	Herrscher des Volkes
Dimitri	Altgriechisch	männlich	der Göttin Demeter geweiht
Dominik	Lateinisch	männlich	zum Herrn gehörend
Duncan	Altirisch	männlich	braun(haariger) Krieger
Dunstan	Altenglisch	männlich	dunkelfarbiger Stein
Dylan	Walisisch	männlich	Meer
Waldemar	Althochdeutsch	männlich	alter deutscher bzw. germanischer zweigliedriger Name
Wallace	Altfranzösisch	männlich	der Fremde, der Kelte
Walter	Althochdeutsch	männlich	alter deutscher zweigliedriger Name
Warren	Altfranzösisch	männlich	ursprünglich ein Familienname normannischer Herkunft
Welch	Altenglisch	männlich	aus Wales
Werner	Althochdeutsch	männlich	alter deutscher zweigliedriger Name
Wieland	Althochdeutsch	männlich	in der germanischen Mythologie und in deutschen Sagen ist Wieland ein begabter Schmied
Wilfried	Althochdeutsch	männlich	alter deutscher zweigliedriger Name
Wilhelm	Althochdeutsch	männlich	alter deutscher zweigliedriger Name
Willibald	Althochdeutsch	männlich	alter deutscher zweigliedriger Name
Winston	Altenglisch	männlich	ursprünglich ein Familienname, vom Namen der kleinen Ortschaft Winston, in Gloucester, England
Wladimir	Altslawisch	männlich	alter slawischer zweigliedriger Name
Wolfgang	Althochdeutsch	männlich	Wolfsgänger
Aaron	Hebräisch	männlich	der Erleuchtete
Abel	Hebräisch	männlich	Hauch, Vergänglichkeit
Abraham	Hebräisch	männlich	Vater der Menge
Adalbero	Althochdeutsch	männlich	alter deutscher zweigliedriger Name
Adam	Hebräisch	männlich	Mensch
Adolf	Althochdeutsch	männlich	alter deutscher zweigliedriger Name
Adrian	Lateinisch	männlich	der aus Hadria
Alan	Keltisch	männlich	kam im Mittelalter mit den Normannen nach England
Alban	Lateinisch	männlich	der aus der Stadt Alba (in Mittelitalien) Stammende
Albert	Althochdeutsch	männlich	alter deutscher zweigliedriger Name
Albin	Lateinisch	männlich	der Weisse
Alexander	Altgriechisch	männlich	der (fremde) Männer Abwehrende, Beschützer der Männer
Alexis	Altgriechisch	männlich	der Beschützer
Alfons	Gothisch	männlich	ursprünglich westgotischer Name, über Spanien nach Deutschland gekommen
Alfred	Altenglisch	männlich	bekannt durch Alfred den Grossen, angelsächsischer König (9. Jh.)
Alois	Altfranzösisch	männlich	'Alois(ius)' ist wahrscheinlich die latinisierte Form von 'Looïs', einer altfranzösischen Variante von Ludwig
Amadeus	Lateinisch	männlich	der von Gott Geliebte
Amando	Lateinisch	männlich	der Liebenswerte
Ambrose	Altgriechisch	männlich	Unsterblich
Amin	Arabisch	männlich	der Vertrauenswürdige
Anakin	Unbekannt	männlich	wahrscheinlich von George Lucas für 'Stars Wars' erfunden, mit 'Annikin' als ursprünglichster Form im Drehbuch
Anastasius	Altgriechisch	männlich	Auferstehung
Andreas	Altgriechisch	männlich	der Männliche, der Tapfere
Andrin	Unbekannt	männlich	vielleicht eine Schweizer/rätoromanische Form von 'Heinrich'
Angelus	Altgriechisch	männlich	Bote Gottes, Engel
Anton	Lateinisch	männlich	ursprünglich ein römischer Familienname, wahrscheinlich etruskischer Herkunft
Apollonius	Altgriechisch	männlich	vom Namen des griechischen Sonnengottes Apollon
Aram	Hebräisch	männlich	Hochland (?)
Aramis	Unbekannt	männlich	bekannt als Name eines der 3 Musketiere in Romanen von Alexander Dumas (1844)
Armin	Germanisch	männlich	Name eines germanischen Kriegs-Fürsten, der 9. n.Chr. ein römisches Heer besiegte
Arnold	Althochdeutsch	männlich	alte deutscher zweigliedriger Name
Arthur	Keltisch	männlich	der Bär (?)
Arvid	Altnordisch	männlich	arn=der Adler (Altnordisch) ; vidr=das Holz, der Baum (Altnordisch)
Arya	Altpersisch	männlich	der Noble, der Freie
Asser	Hebräisch	männlich	glücklich, gesegnet
August	Lateinisch	männlich	der Erhabene
Aurel	Lateinisch	männlich	ursprünglich ein römischer Familienname 'Aurelius'
Axel	Hebräisch	männlich	(Gott-)Vater ist der Friede
Xenia	Altgriechisch	weiblich	Gastfreundschaft
Waltraud	Althochdeutsch	weiblich	alter deutscher zweigliedriger Name
Wanda	Althochdeutsch	weiblich	aus dem Polnischen ins Deutsche übernommener Name mit nicht genau bekannter Herkunft
Abigail	Hebräisch	weiblich	Freude meines Vaters, der Vater hat sich gefreut
Adela	Althochdeutsch	weiblich	verselbständigte Kurzform von Namen, die mit 'Adel-' beginnen, insbesondere Adelheid
Adelheid	Althochdeutsch	weiblich	von edlem Wesen
Adriana	Lateinisch	weiblich	die Frau aus Hadria
Afra	Lateinisch	weiblich	die Afrikanerin
Agathe	Altgriechisch	weiblich	die Gute
Agnes	Altgriechisch	weiblich	die Reine
Aino	Finnisch	weiblich	die Einzigartige
Alamea	Hawaiianisch	weiblich	kostbar
Alberta	Althochdeutsch	weiblich	Siehe männliche FormAlbert
Albina	Lateinisch	weiblich	die Weisse
Alesya	Unbekannt	weiblich	vielleicht eine ursprünglich russische Form von 'Alexia' oder 'Alexandra'
Alexandra	Altgriechisch	weiblich	Beschützerin der Männer
Aliyah	Hebräisch	weiblich	der Aufstieg
Amanda	Lateinisch	weiblich	die Liebenswerte
Amina	Arabisch	weiblich	die Vertrauenswürdige
Anah	Hebräisch	weiblich	Antwort
Anahita	Altpersisch	weiblich	die Makellose
Anastasia	Altgriechisch	weiblich	Auferstehung
Andrea	Altgriechisch	weiblich	die Männliche, die Tapfere
Angela	Altgriechisch	weiblich	Bote Gottes, Engel
Anna	Hebräisch	weiblich	die Begnadete, er (Gott) war gnädig
Anndea	Deutsch	weiblich	Doppelform aus 'Anna' und 'Dea'
Apollonia	Altgriechisch	weiblich	Siehe männliche FormApollonius
Aranka	Ungarisch	weiblich	Gold
Arda	Althochdeutsch	weiblich	holländische Kurzform von Namen mit dem Element 'arn' (Adler)
Aretha	Altgriechisch	weiblich	vielleicht zu griechisch 'arete' (Tugend)
Ariadne	Altgriechisch	weiblich	sehr heilige Frau
Arife	Türkisch	weiblich	Abend, Vorabend
Astrid	Altnordisch	weiblich	alter nordischer zweigliedriger Name
Atalja	Hebräisch	weiblich	Jahwe ist erhaben
Aurelia	Lateinisch	weiblich	Siehe männliche FormAurel
Kai	Althochdeutsch	weiblich	Herkunft nicht sicher geklärt
Kamilla	Lateinisch	weiblich	Messdiener (?)
Karin	Altgriechisch	weiblich	die Reine (?)
Karola	Althochdeutsch	weiblich	Siehe männliche FormKarl
Kassandra	Altgriechisch	weiblich	nach der griechischen Sage sagte Kassandra vergebens den Untergang Trojas voraus und warnte vor dem hölzernen Pferd
Katharina	Altgriechisch	weiblich	die Reine (?)
Kezia	Hebräisch	weiblich	Zimt(pflanze)
Khadija	Arabisch	weiblich	Frühgeburt
Kiana	Unbekannt	weiblich	Naturelemente, die 4 Elemente
Kianna	Unbekannt	weiblich	vielleicht moderne Neubildung als Kombination der Silbe 'Ki' bzw. 'Ke' und dem Namen 'Anna'
Kimberley	Altenglisch	weiblich	Cyneburgas Feld
Klara	Lateinisch	weiblich	hell, klar, strahlend
Klothilde	Althochdeutsch	weiblich	alter deutscher zweigliedriger Name
Konstanze	Lateinisch	weiblich	die Standhafte
Kunigunde	Althochdeutsch	weiblich	alter deutscher zweigliedriger Name
Kyra	Altpersisch	weiblich	Siehe männliche FormKyros
Sachso	Althochdeutsch	männlich	der Sachse
Salomon	Hebräisch	männlich	der Friedliche
Salvatore	Lateinisch	männlich	der Retter, der Erlöser
Samir	Arabisch	männlich	Bedeutung in etwa 'Begleiter bei abendlichem Gespräch'
Samuel	Hebräisch	männlich	Bedeutung nicht sicher geklärt
Sascha	Russisch	männlich	ursprünglich russische Koseform von Alexander bzw. Alexandra, heute wie ein selbständiger Name in Gebrauch
Scott	Keltisch	männlich	der Schotte
Sebastian	Altgriechisch	männlich	der Mann aus Sebaste
Serenus	Lateinisch	männlich	der Heitere
Serge	Etruskisch	männlich	ursprünglich ein römischer Familienname
Seth	Hebräisch	männlich	der Berufene
Severin	Lateinisch	männlich	der Ernsthafte
Sidonius	Lateinisch	männlich	Mann aus Sidon
Siegbert	Althochdeutsch	männlich	alter deutscher zweigliedriger Name
Siegfried	Althochdeutsch	männlich	alter deutscher zweigliedriger Name
Sileno	Altgriechisch	männlich	in der griechischen Mythologie ist Silenos ein Begleiter von Dionysos, dem Gott des Weines
Silvan	Lateinisch	männlich	von 'Silvanus', dem Namen des altrömischen Gottes des Waldes
Silvester	Lateinisch	männlich	aus dem Wald
Silvius	Lateinisch	männlich	Mann aus dem Wald
Simon	Hebräisch	männlich	Er (Gott) hat gehört
Solideo	Lateinisch	männlich	nur für Gott
Stanislaw	Altslawisch	männlich	alter slawischer zweigliedriger Name
Stanley	Altenglisch	männlich	Stein-Lichtung, Stein-Wiese
Stefan	Altgriechisch	männlich	der Gekrönte
Stewart	Altenglisch	männlich	Hüter des Hauses
Sven	Altnordisch	männlich	Jüngling, junger Mann
Tabitha	Aramäisch	weiblich	Gazelle
Tamaja	Unbekannt	weiblich	im Zentrum (?)
Tamara	Hebräisch	weiblich	Dattelpalme
Tamika	Englisch	weiblich	moderne Bildung, vielleicht basierend auf 'tamu' (süss)
Tanith	Phönizisch	weiblich	Herrin der Schlangen (?)
Tatjana	Lateinisch	weiblich	von der weiblichen Form des römischen Vornamens 'Tatianus', der vom Familiennamen 'Tatius' abgeleitet ist
Taya	Unbekannt	weiblich	vielleicht abgeleitet von 'Taylor'
Thekla	Altgriechisch	weiblich	Ruhm Gottes
Theodora	Altgriechisch	weiblich	das Gottesgeschenk
Theresa	Altgriechisch	weiblich	die Jägerin (?)
Thorhild	Altnordisch	weiblich	alter nordischer zweigliedriger Name
Tímea	Unbekannt	weiblich	vielleicht erfunden vom ungarischen Autor Mor Jokai 1873
Tina	Deutsch	weiblich	verselbständigte Kurzform von Namen, die auf '-tina' oder '-tine' enden, wie z.B. Christina, Bettina und Albertina
Tomma	Friesisch	weiblich	verselbständigte Kurzform von Namen mit 'Dank-' (die heute kaum mehr in Gebrauch sind)
Malik	Arabisch	männlich	der König
Manfred	Althochdeutsch	männlich	alter deutscher zweigliedriger Name
Manuel	Hebräisch	männlich	Gott sei mit uns
Marcel	Lateinisch	männlich	von 'Marcellus', einer Weiterbildung bzw. Verkleinerungsform von 'Marcus'
Marin	Lateinisch	männlich	vom Meer, am Meer lebend
Marius	Lateinisch	männlich	ursprünglich ein altrömischer Familienname
Markus	Lateinisch	männlich	dem Mars (dem römischen Kriegsgott) geweiht
Martial	Lateinisch	männlich	von einem römischen Beinamen 'Martialis', abgeleitet vom Namen des Kriegsgottes Mars
Martin	Lateinisch	männlich	geht zurück auf den römischen Beinamen 'Martinus', der wiederum auf den Namen des Kriegsgottes Mars zurückgeht
Matthias	Hebräisch	männlich	Gabe Jahwes
Maxim	Lateinisch	männlich	der Grösste
Maximilian	Lateinisch	männlich	bekannt als Heiligenname und als Name diverser Herrscher
Michael	Hebräisch	männlich	Wer ist wie Gott?
Milan	Altslawisch	männlich	ursprünglich Kurzform für Namen mit dem ersten Element 'mil' (lieb, teuer)
Miroslaw	Altslawisch	männlich	alter slawischer Name, als Wortzusammensetzung
Morgan	Keltisch	männlich	alter keltischer bzw. walisischer Name, dessen Bedeutung nicht sicher geklärt ist
Moritz	Lateinisch	männlich	der aus Mauretanien Stammende, der Mohr
Mufid	Arabisch	männlich	nützlich
Myron	Arabisch	männlich	Myrrhe
Ladina	Rätoromanisch	weiblich	vielleicht vom Namen der Sprache Latein, 'Latinum'
Larina	Lateinisch	weiblich	Möwe (?)
Larissa	Altgriechisch	weiblich	die Liebliche (?)
Latifa	Arabisch	weiblich	freundlich, sanft
Laura	Lateinisch	weiblich	Siehe männliche FormLorenz
Lea	Hebräisch	weiblich	Wildkuh; müde
Leandra	Altgriechisch	weiblich	Mann des Volkes (?), ein Löwe von einem Mann (?)
Lee	Altenglisch	weiblich	geht zurück auf einen Familiennamen, der wiederum auf eine häufige Ortsbezeichnung zurückgeht
Leia	Unbekannt	weiblich	vielleicht eine französische Abwandlung von 'Lea'
Leila	Arabisch	weiblich	die Nacht
Leonie	Lateinisch	weiblich	der Löwe
Lina	Deutsch	weiblich	verselbständigte Kurzform von Namen mit Endung '-lina', besonders von Karolina
Linda	Althochdeutsch	weiblich	Kurzform von Namen auf -linda, z.B. Rosalinda
Linde	Althochdeutsch	weiblich	Kurzform von Namen auf -linde, z.B. Rosalinde
Liv	Altnordisch	weiblich	Schutz; Leben
Livia	Lateinisch	weiblich	Siehe männliche FormLivius
Lorna	Englisch	weiblich	erfunden vom englischen Schriftsteller R. D. Blackmore für die Heldin seines Romans 'Lorna Doone' (1869)
Louise	Althochdeutsch	weiblich	Siehe männliche FormLudwig
Louise-Anne	Französisch	weiblich	Doppelform aus 'Louise' und 'Anne'
Luana	Englisch	weiblich	erfundener Name, Kombination von 'Lou' und 'Ana', erstmals verwendet 1932 im Film 'The Bird of Paradise'
Lucia	Lateinisch	weiblich	die Strahlende; die bei Tagesanbruch Geborene
Ludmilla	Altslawisch	weiblich	alter slawischer Name, aus dem Tschechischen ins Deutsche übernommen
Lydia	Altgriechisch	weiblich	die Lydierin
Nahor	Hebräisch	männlich	schnaubend
Nathan	Hebräisch	männlich	ursprünglich eine Kurzform von 'Jonathan' und 'Nathanael'
Nathanael	Hebräisch	männlich	Gott hat gegeben
Naveen	Sanskrit	männlich	der Neue
Nemo	Lateinisch	männlich	Niemand
Nevio	Lateinisch	männlich	von einem römischen Familiennamen 'Naevius', der vielleicht auf 'naevus' (Fehler, aber auch Muttermal) zurückgeht
Nikolaus	Altgriechisch	männlich	Sieg des Volkes
Noah	Hebräisch	männlich	Beruhige Dich (, Gott)!
Noel	Lateinisch	männlich	der an Weihnachten Geborene
Norbert	Althochdeutsch	männlich	alter deutscher zweigliedriger Name
Norman	Althochdeutsch	männlich	Mann aus dem Norden, der Normanne
Notker	Althochdeutsch	männlich	alter deutscher zweigliedriger Name
Noyan	Unbekannt	männlich	vielleicht von einem gleichlautenden mongolischen Titel für einen militärischen Befehlshaber
Nyima	Tibetanisch	männlich	Sonne
Dagmar	Altslawisch	weiblich	die Friedliebende
Dairine	Altirisch	weiblich	daire=fruchtbar (Altirisch)
Dalisay	Tagalog	weiblich	rein
Damiana	Altgriechisch	weiblich	Siehe männliche FormDamian
Daniela	Hebräisch	weiblich	Gott sei mein Richter
Daria	Altpersisch	weiblich	das Gute festhaltend; Inhaber des Guten
Darina	Unbekannt	weiblich	Darina&nbsp;&nbsp;Tschechisch, Slawisch&nbsp;&nbsp;
Davida	Hebräisch	weiblich	der Geliebte
Dea	Lateinisch	weiblich	die Göttin
Deborah	Hebräisch	weiblich	Biene
Deina	Unbekannt	weiblich	vielleicht von 'Deiene', was wiederum vielleicht eine baskische Bezeichnung für das Fest 'Mariä Verkündigung' ist
Denise	Altgriechisch	weiblich	die dem Dionysos Geweihte
Diana	Lateinisch	weiblich	in der römischen Mythologie ist Diana die Göttin der Jagd und des Mondes
Dominika	Lateinisch	weiblich	zum Herrn gehörend
Donata	Lateinisch	weiblich	die Geschenkte; die Gott Geschenkte; die von Gott Geschenkte
Doris	Altgriechisch	weiblich	die Dorerin
Dorothea	Altgriechisch	weiblich	Gottesgeschenk
Dynelle	Unbekannt	weiblich	Dynelle&nbsp;&nbsp;Englisch&nbsp;&nbsp;
Gabriele	Hebräisch	weiblich	Mann Gottes, Held Gottes; Gott ist mein Held
Gefion	Altnordisch	weiblich	die Geberin
Georgia	Altgriechisch	weiblich	die Bäuerin
Geraldine	Althochdeutsch	weiblich	Siehe männliche FormGerald
Gertrud	Althochdeutsch	weiblich	alter deutscher zweigliedriger Name
Gisela	Althochdeutsch	weiblich	die Geisel
Gloria	Lateinisch	weiblich	Ruhm, Ehre
Grazyna	Litauisch	weiblich	die Schöne
Griselda	Althochdeutsch	weiblich	aus dem Italienischen übernommen, wo dies der Name einer Sagengestalt ist
Gudrun	Althochdeutsch	weiblich	alter deutscher bzw. nordischer zweigliedriger Name
Gunda	Althochdeutsch	weiblich	Kurzform von Namen auf '-gunda' oder '-gunde', wie z.B. Kunigunde
Gunnlöd	Altnordisch	weiblich	in der nordischen Mythologie ist Gunnlöd eine Riesin
Gwendolin	Walisisch	weiblich	weisser Kreis
Jacqueline	Hebräisch	weiblich	Jahwe möge schützen; Fersenhalter; er betrügt
Jael	Hebräisch	weiblich	Bergziege
Jarina	Unbekannt	weiblich	vielleicht eine Abwandlung von 'Georgina'
Jasmin	Altpersisch	weiblich	Jasmin
Jasna	Polnisch	weiblich	hell
Jelsha	Rätoromanisch	weiblich	Jelsha&nbsp;&nbsp;Rätoromanisch&nbsp;&nbsp;
Jelyssa	Englisch	weiblich	Doppelform aus 'Jenna' und 'Alyssa'
Jemima	Hebräisch	weiblich	Taube (?)
Jennifer	Walisisch	weiblich	in der Artus-Sage ist Guinevere die Gemahlin von König Artus
Jessica	Hebräisch	weiblich	Er (Gott) schaut
Jocelyn	Altfranzösisch	weiblich	ursprünglich 'Gautzelin', abgeleitet vom Stammesnamen der Goten, als doppelte Verkleinerung
Joelle	Hebräisch	weiblich	Jahwe ist Gott
Johanna	Hebräisch	weiblich	Jahwe ist gnädig, Jahwe ist gütig
Jolie	Französisch	weiblich	hübsch
Josepha	Hebräisch	weiblich	Er (Gott) fügt hinzu
Judith	Hebräisch	weiblich	Frau aus Jehud; Jüdin
Julia	Lateinisch	weiblich	Siehe männliche FormJulius
Juliana	Lateinisch	weiblich	Siehe männliche FormJulian
Justine	Lateinisch	weiblich	die Gerechte
Fabian	Lateinisch	männlich	vom römischen Vornamen 'Fabianus', der vom römischen Familiennamen 'Fabius' abgeleitet ist
Fabius	Lateinisch	männlich	ursprünglich ein römischer Familienname, wahrscheinlich abgeleitet vom Wort 'faba' (Bohne)
Fabrizius	Lateinisch	männlich	Handwerker, Schmid
Falko	Althochdeutsch	männlich	der Falke
Fathi	Arabisch	männlich	Eroberer
Faustus	Lateinisch	männlich	der Glückbringende
Felix	Lateinisch	männlich	der Glückliche, der Erfolgreiche
Ferdinand	Gothisch	männlich	kühner Beschützer
Fikri	Arabisch	männlich	Denker
Finn	Altirisch	männlich	der Blonde
Flavio	Lateinisch	männlich	gelb-haarig, blond
Florens	Lateinisch	männlich	der in hohem Ansehen Stehende
Florian	Lateinisch	männlich	im Mittelalter verbreitet durch die Verehrung des hl. Florian (4. Jh.)
Floyd	Keltisch	männlich	grau; grauhaarig
Frank	Althochdeutsch	männlich	vom Volksstamm der Franken
Franz	Italienisch	männlich	der kleine Franzose
Fridtjof	Altisländisch	männlich	fridr=der Schutz, der Friede (Altisländisch) ; thjofr=der Dieb (Altisländisch)
Friedemann	Deutsch	männlich	Koseform von Namen, die mit dem Element 'Fried-' beginnen, wie z.B. Friedrich
Friedrich	Althochdeutsch	männlich	alter deutscher zweigliedriger Name
Ulrike	Althochdeutsch	weiblich	Siehe männliche FormUlrich
Unn	Altnordisch	weiblich	Liebe
Ursula	Lateinisch	weiblich	die kleine Bärin
Ute	Althochdeutsch	weiblich	Siehe männliche FormOtto
Barbara	Lateinisch	weiblich	die Fremde
Beate	Lateinisch	weiblich	die Glückliche
Beatrix	Lateinisch	weiblich	Reisende, Pilgerin
Belana	Keltisch	weiblich	Licht-Mutter
Belanna	Unbekannt	weiblich	vielleicht eine Bildung aus einem Namen, der mit 'Bel-' beginnt, wie etwa 'Bella', und 'Anna' als zweitem Namen
Belinda	Althochdeutsch	weiblich	Herkunft nicht sicher geklärt
Beniese	Deutsch	weiblich	Beniese&nbsp;&nbsp;Deutsch&nbsp;&nbsp;
Berta	Althochdeutsch	weiblich	Siehe männliche FormBert
Binia	Unbekannt	weiblich	vielleicht entstanden aus einer Kurzform 'Bina' von 'Sabina'
Bithiah	Hebräisch	weiblich	Tochter von Jahwe
Blanka	Spanisch	weiblich	die Weisse
Bliktrud	Althochdeutsch	weiblich	bekannt durch die hl. Plektrudis (8. Jh.)
Brettina	Unbekannt	weiblich	vielleicht eine Doppelform aus 'Brett' und 'Tina'
Brigitte	Keltisch	weiblich	die Erhabene
Valena	Lateinisch	weiblich	vielleicht die weibliche Form des römischen Familiennamens 'Valenus'
Valentina	Lateinisch	weiblich	die Kräftige, die Starke
Valerie	Lateinisch	weiblich	die Kräftige, die Gesunde
Vanessa	Lateinisch	weiblich	Erfindung des irischen Schriftstellers Swift für ein Gedicht 1726
Vera	Russisch	weiblich	Glaube
Verena	Lateinisch	weiblich	Herkunft unklar, vielleicht zu lat. 'verus' bzw. dessen weiblicher Form
Verna	Altfranzösisch	weiblich	Siehe männliche FormVernon
Veronika	Altgriechisch	weiblich	die Siegbringende
Viktoria	Lateinisch	weiblich	Sieg
Viola	Lateinisch	weiblich	das Veilchen
Virginia	Lateinisch	weiblich	die Jungfräuliche
Viviane	Etruskisch	weiblich	Siehe männliche FormVivian
Vivienne	Keltisch	weiblich	in der Artus-Sage ist Vivienne oder Niniane eine Zauberin, die Merlin gefangenhält, und die Erzieherin von Lancelot
Camillo	Lateinisch	männlich	Messdiener (?)
Carey	Altirisch	männlich	Nachfahre von Ciardha
Cedric	Englisch	männlich	geliebt (?)
Celio	Lateinisch	männlich	ursprünglich ein römischer Familienname 'Caelius', der sich wahrscheinlich vom Wort 'caelum' (Himmel) ableitet
Christian	Lateinisch	männlich	Anhänger Christi, Christ
Christoph	Altgriechisch	männlich	Christus tragend
Claudius	Lateinisch	männlich	der Hinkende
Clemens	Lateinisch	männlich	der Gnädige
Cölestin	Lateinisch	männlich	der Himmlische
Conan	Keltisch	männlich	der Erhabene (?); Jagdhund (?)
Cornelius	Lateinisch	männlich	von einem altrömischen Familiennamen, dem vielleicht das Wort 'cornu' (Horn) zugrundeliegt
Cosmo	Altgriechisch	männlich	verselbständigte Kurzform von Namen mit dem Element 'kosmos'
Crispin	Lateinisch	männlich	kraushaarig
Curtis	Altfranzösisch	männlich	höfisch (zum Hof gehörig), höflich
Cyrill	Altgriechisch	männlich	der rechte Herr/Gebieter
Edeltraud	Althochdeutsch	weiblich	alter deutscher zweigliedriger Name
Edith	Altenglisch	weiblich	altenglischer zweigliedriger Name, der bereits vor der Eroberung durch die Normannen existierte
Eduarda	Altenglisch	weiblich	Hüter seines Besitzes
Egzonjeta	Albanisch	weiblich	erfreuliches Leben (?)
Ehrentraud	Althochdeutsch	weiblich	alter deutscher zweigliedriger Name
Eleonora	Alt-Provenzalisch	weiblich	von einem alten provenzalischen Namen 'Alienor'
Elisabeth	Hebräisch	weiblich	Mein Gott ist Fülle; Mein Gott hat geschworen
Elvira	Gothisch	weiblich	aus dem Spanischen ins Deutsche übernommener Name westgotischer Herkunft
Emilia	Lateinisch	weiblich	Siehe männliche FormEmil
Emma	Germanisch	weiblich	verselbständigte Kurzform von Namen beginnend mit 'Erm-' oder 'Irm-' wie z.B. Irmgard
Emmeline	Gothisch	weiblich	verselbständigte Kurzform von Namen, die mit 'Amal-' gebildet wurden (z.B. Amalberga, Amalgund)
Engel	Althochdeutsch	weiblich	verselbständigte Kurzform von Namen mit dem ersten Element 'Engel'
Enola	Englisch	weiblich	erst im 20. Jh. erschienen
Enya	Altirisch	weiblich	eithne=der Kern, der Samenkern (Altirisch)
Ercilia	Lateinisch	weiblich	in der römischen Mythologie ist Hersilia die sabinische Frau des Romulus, einem der beiden Gründer von Rom
Erdmute	Deutsch	weiblich	um das Jahr 1600 herum neu gebildet
Ernesta	Althochdeutsch	weiblich	der Ernste, der Gestrenge
Eva	Hebräisch	weiblich	Leben, die Leben Spendende
Evdokia	Altgriechisch	weiblich	Wohlgefallen, Wunsch
Eveline	Altfranzösisch	weiblich	geht zurück auf den altfranzösisch-normannischen Namen 'Aveline'
Raimund	Althochdeutsch	männlich	alter deutscher zweigliedriger Name
Rainer	Althochdeutsch	männlich	alter deutscher zweigliedriger Name
Ralf	Althochdeutsch	männlich	alter deutscher zweigliedriger Name
Ramzi	Arabisch	männlich	Symbol, Geheimnis (?)
Randolf	Althochdeutsch	männlich	alter deutscher zweigliedriger Name
Raphael	Hebräisch	männlich	Gott hat geheilt
Razvan	Rumänisch	männlich	Razvan&nbsp;&nbsp;Rumänisch&nbsp;&nbsp;
Reiko	Friesisch	männlich	friesische Kurzform von Namen mit dem ersten Element 'ragin', wie. z.B. Reinhold oder Raimund
Reinhard	Althochdeutsch	männlich	alter deutscher zweigliedriger Name
Reinhold	Althochdeutsch	männlich	alter deutscher zweigliedriger Name
Rembert	Althochdeutsch	männlich	alter deutscher zweigliedriger Name
Remo	Lateinisch	männlich	Name eines der beiden Gründer von Rom
Renato	Lateinisch	männlich	der Wiedergeborene
Reto	Lateinisch	männlich	der Rätoromane
Rex	Lateinisch	männlich	König
Rhydian	Unbekannt	männlich	vielleicht von walisisch 'rhyd' (Furt)
Richard	Althochdeutsch	männlich	alter germanischer bzw. deutscher zweigliedriger Name
Rivelino	Portugiesisch	männlich	vielleicht Gebrauch des Familiennamens des bekannten brasilianischen Fussballers Roberto Rivellino als Vorname
Riziero	Unbekannt	männlich	vielleicht von italienisch 'ricco' (gekräuselt, gelockt)
Robert	Althochdeutsch	männlich	alter germanischer bzw. deutscher zweigliedriger Name
Roderich	Althochdeutsch	männlich	alter germanischer bzw. deutscher zweigliedriger Name
Roger	Althochdeutsch	männlich	alter deutscher zweigliedriger Name
Rojan	Kurdisch	männlich	roj=die Sonne, der Tag (Kurdisch)
Roland	Althochdeutsch	männlich	alter deutscher zweigliedriger Name
Roman	Lateinisch	männlich	der Römer
Romeo	Lateinisch	männlich	Rom-Pilger
Roy	Keltisch	männlich	der Rote, der Rootharige
Rudolf	Althochdeutsch	männlich	alter deutscher zweigliedriger Name
Rune	Altnordisch	männlich	run=das Geheimnis, die Rune (Altnordisch)
Lambert	Althochdeutsch	männlich	alter deutscher zweigliedriger Name
Latif	Arabisch	männlich	freundlich, sanft
Lauris	Unbekannt	männlich	vielleicht eine lettische Form von 'Lorenz'
Lawley	Altenglisch	männlich	von einem Familiennamen, der vielleicht auf eine Ortsbezeichnung mit der Bedeutung 'Lafas Wiese' oder 'Lafas Lichtung' zurückgeht
Leander	Altgriechisch	männlich	Mann des Volkes (?), ein Löwe von einem Mann (?)
Lee	Altenglisch	männlich	geht zurück auf einen Familiennamen, der wiederum auf eine häufige Ortsbezeichnung zurückgeht
Lembit	Unbekannt	männlich	Lembit&nbsp;&nbsp;Estnisch&nbsp;&nbsp;
Lenas	Litauisch	männlich	Lenas&nbsp;&nbsp;Litauisch&nbsp;&nbsp;
Leo	Lateinisch	männlich	der Löwe
Leonhard	Althochdeutsch	männlich	alter deutscher zweigliedriger Name
Leontina	Lateinisch	männlich	löwenhaft
Leopold	Althochdeutsch	männlich	alter deutscher zweigliedriger Name
Levente	Ungarisch	männlich	seiend, existierend (?)
Linus	Altgriechisch	männlich	der Klagende, der Trauernde
Livius	Lateinisch	männlich	ursprünglich ein römischer Familienname 'Livius'
Loki	Altnordisch	männlich	Bedeutung unbekannt, vielleicht von einer indoeuropäischen Wurzel 'leug' (biegen, brechen)
Lorenz	Lateinisch	männlich	geht zurück auf den altrömischen Beinamen 'Laurentius': 'der aus der Stadt Laurentium Stammende'
Lothar	Althochdeutsch	männlich	alter deutscher bzw. altfränkischer zweigliedriger Name
Lucius	Lateinisch	männlich	der Strahlende, der bei Tagesanbruch Geborene
Ludwig	Althochdeutsch	männlich	alter deutscher zweigliedriger Name
Lukas	Altgriechisch	männlich	der aus Lucania Stammende
Kai	Althochdeutsch	männlich	Herkunft nicht sicher geklärt
Kajetan	Lateinisch	männlich	aus der Stadt Caieta stammend
Karl	Althochdeutsch	männlich	alter deutscher Name
Kasimir	Polnisch	männlich	alter slawischer Name
Kaspar	Altpersisch	männlich	Verwalter der Schätze
Keith	Keltisch	männlich	Wald
Ken	Keltisch	männlich	der Schöne
Kevin	Altirisch	männlich	der Schöne, der Angenehme
Kilian	Altirisch	männlich	Krieg, Kampf (?)
Klaus	Altgriechisch	männlich	seit dem Mittelalter verselbständigte Kurzform von 'Nikolaus'
Knut	Altnordisch	männlich	Knoten
Konrad	Althochdeutsch	männlich	alter deutscher zweigliedriger Name
Konstantin	Lateinisch	männlich	der Standhafte
Kunibert	Althochdeutsch	männlich	alter deutscher zweigliedriger Name
Kuno	Althochdeutsch	männlich	alter deutscher Name
Kurt	Althochdeutsch	männlich	verselbständigte Kurzform von 'Konrad'
Kyros	Altpersisch	männlich	von der griechischen Form eines persischen Namens 'Kurus' oder 'Kurush', dem Namen mehrerer Könige
Ida	Althochdeutsch	weiblich	verselbständigte Kurzform von (heute nicht mehr gebräuchlichen) Namen mit 'Ida-', z.B. 'Idaberga'
Ilana	Hebräisch	weiblich	Baum
Ilenia	Hebräisch	weiblich	Pflanze, Knospe (?)
Ilia	Unbekannt	weiblich	in der römischen Mythologie ist Ilia (auch Rhea Silvia genannt) die Mutter von Romulus und Remus, den beiden Gründern von Rom
Imke	Friesisch	weiblich	friesische Koseform von Namen, die mit 'Irm-' gebildet sind, besonders von 'Irmgard'
Immacolata	Lateinisch	weiblich	die Unbefleckte
Ina	Deutsch	weiblich	verselbständigte Kurzform von Namen, die auf '-ina' enden, wie z.B. 'Regina'
Indigo	Englisch	weiblich	Indigo
Inge	Althochdeutsch	weiblich	Siehe männliche FormIngo
Ingeborg	Altnordisch	weiblich	alter skandinavischer zweigliedriger Name
Ingrid	Altnordisch	weiblich	alter nordischer zweigliedrieger Name
Inse	Friesisch	weiblich	verselbständigte friesische Kurz- bzw. Koseform von Namen, die mit 'Ing' beginnen, z.B. Ingeborg
Iphigenie	Altgriechisch	weiblich	stark geboren
Irene	Altgriechisch	weiblich	die Friedfertige
Iris	Altgriechisch	weiblich	Regenbogen
Irma	Althochdeutsch	weiblich	verselbständigte Kurzform von Namen beginnend mit 'Irm-', z.B. 'Irmgard'
Irmgard	Althochdeutsch	weiblich	alter deutscher zweigliedriger Name
Isabella	Hebräisch	weiblich	Mein Gott ist Vollkommenheit; oder: der Schwur Gottes
Isha	Sanskrit	weiblich	Beschützer
Ulf	Altnordisch	männlich	der Wolf
Ulrich	Althochdeutsch	männlich	alter deutscher zweigliedriger Name
Urban	Lateinisch	männlich	der Städter
Urs	Lateinisch	männlich	der Bär
Uwe	Altnordisch	männlich	'Uwe' ist wahrscheinlich eine friesische Form des skandinavischen Namens 'Ove', älter 'Aghi'
Zeruja	Hebräisch	weiblich	Balsam
Zita	Italienisch	weiblich	das junge Mädchen
Zoe	Altgriechisch	weiblich	Leben
